12 12
6 6 6 0 0 6 0 6 6 6 6 6
6 6 0 0 0 0 0 0 0 0 6 6
0 0 0 0 0 0 0 0 0 0 6 6
0 0 0 0 0 0 0 0 0 0 6 6
6 6 0 0 0 0 0 0 0 0 6 6
6 6 6 0 0 0 0 0 0 0 6 6
6 6 6 6 6 6 6 6 0 0 6 6
6 6 6 6 3 0 0 0 0 0 1 2
6 6 6 0 4 0 0 0 0 0 1 2
6 0 0 0 4 0 0 0 0 1 2 2
6 6 6 0 4 0 0 0 0 1 2 2
6 6 0 0 5 0 0 1 2 2 2 2