32 32
14 10 10 10 13 10 10 10 10 10 10 10 10 10 10 10 14 15 10 14 10 13 10 15 10 14 14 14 13 10 10 14
10 10 10 14 10 10 10 15 10 10 10 10 10 10 10 10 14 13 13 15 14 15 13 14 13 15 10 15 14 15 10 15
13 15 20 20 20 20 10 20 20 20 14 20 20 13 20 14 20 20 20 20 20 20 20 20 20 20 20 20 20 20 13 13
14 10 20 37 38 20 14 20 20 20 14 20 20 20 20 20 20 20 20 20 20 20 20 20 20 20 20 20 20 20 10 15
10 15 20 40 39 20 13 20 20 20 14 20 20 20 20 20 20 20 10 14 13 13 15 15 15 15 10 14 20 20 14 10
10 10 20 20 20 20 20 20 20 20 14 20 20 15 20 15 20 20 13 20 20 20 20 20 20 20 20 14 20 20 13 10
14 10 13 14 14 20 20 20 20 20 20 20 20 20 20 20 20 20 14 20 20 20 20 20 20 20 20 14 20 20 15 13
10 15 20 20 20 20 20 20 20 20 20 20 20 20 20 20 20 20 15 15 14 13 15 15 20 20 20 13 20 20 13 14
10 10 20 20 20 20 20 20 20 15 14 20 20 14 20 10 20 20 15 42 42 41 41 43 20 20 20 15 20 20 10 13
10 15 20 20 20 20 20 20 15 20 14 20 20 20 20 20 20 20 15 20 20 20 20 20 20 20 20 15 20 20 15 14
14 10 20 20 20 15 15 15 20 20 15 20 20 20 20 20 20 20 15 20 20 20 20 20 20 20 20 15 20 20 13 15
10 14 20 20 20 20 20 20 20 20 14 20 20 13 20 14 20 20 15 20 20 20 20 20 20 20 20 20 20 20 10 10
10 13 20 20 20 20 20 20 20 20 14 20 20 20 20 20 20 20 15 20 20 20 20 20 20 20 20 20 20 20 15 13
14 15 15 15 15 15 14 20 20 14 14 20 20 20 20 20 20 20 15 20 20 20 20 20 20 20 20 15 20 20 13 10
13 15 20 20 15 37 20 20 20 20 15 15 15 15 15 15 15 15 15 20 20 20 20 20 20 20 20 15 20 20 15 14
14 10 20 20 15 40 20 20 20 20 15 39 20 20 20 20 20 20 20 20 20 20 20 20 20 20 20 15 20 20 14 13
10 13 20 20 15 37 20 20 20 20 15 20 20 20 20 20 20 20 20 20 20 20 20 20 20 20 20 15 20 20 10 14
14 10 20 20 15 15 20 20 20 20 15 20 20 20 20 15 15 15 15 15 15 15 15 20 20 13 14 13 13 15 15 15
15 13 20 20 20 15 20 20 20 20 15 20 20 20 37 15 20 20 20 20 20 40 15 20 20 20 20 20 20 40 13 10
10 10 20 20 20 15 20 20 20 20 15 20 20 15 15 15 20 20 20 20 20 20 15 20 20 20 20 20 20 20 13 15
13 14 20 20 20 15 20 20 20 20 13 20 20 20 20 20 20 20 20 20 20 20 15 20 20 15 13 14 20 20 14 10
13 10 20 20 20 15 20 20 20 20 14 20 20 20 20 20 20 20 20 20 20 20 15 20 20 14 13 10 20 20 15 14
10 15 20 20 20 15 15 15 15 15 15 15 15 15 15 15 15 20 20 20 20 20 15 20 20 20 20 20 20 20 14 10
10 13 20 20 20 20 20 20 20 20 20 20 34 20 20 20 15 20 20 20 20 20 15 20 20 20 20 20 20 20 13 14
14 13 20 20 20 20 20 20 20 20 20 20 35 20 20 20 15 20 20 20 20 20 15 15 15 15 15 15 15 15 14 13
15 10 20 20 20 20 20 15 20 20 15 20 35 20 20 20 15 20 20 20 20 20 20 20 20 20 20 20 20 20 13 10
13 10 20 20 20 20 20 15 20 20 15 20 36 20 20 20 15 20 20 20 20 20 20 20 20 20 20 20 20 20 15 13
10 15 15 15 15 15 15 15 20 20 15 15 15 15 15 15 15 15 15 15 15 15 15 15 15 15 15 15 20 20 13 15
14 15 41 42 42 41 41 43 20 20 20 20 20 20 20 20 20 20 20 20 20 20 20 20 20 20 20 20 20 20 15 14
15 33 20 20 20 20 20 20 20 20 20 20 20 20 20 20 20 20 20 20 20 20 20 20 20 20 20 20 20 20 13 10
10 13 14 15 13 14 15 10 13 10 10 13 14 10 15 14 13 10 14 13 15 10 13 10 14 15 13 14 10 13 14 13
15 13 10 14 10 13 14 15 10 14 13 14 10 14 10 13 10 15 14 10 14 13 10 13 10 14 15 10 13 14 10 14