16 16
14 10 10 10 13 10 10 10 10 10 10 10 10 10 10 10
10 10 10 14 10 10 10 15 10 10 10 10 10 10 10 10
14 10 6 6 6 0 0 6 0 6 6 6 6 6 15 10
13 10 6 6 3 0 0 0 0 0 0 0 6 6 10 10
10 11 0 0 4 0 0 0 0 0 0 0 6 6 10 10
10 12 0 0 4 0 0 0 0 0 0 0 6 6 14 10
14 10 6 6 5 0 0 0 0 0 0 0 6 6 10 13
10 15 6 6 6 0 0 0 0 0 0 0 6 6 13 10
10 10 6 6 6 6 6 6 6 6 0 0 6 6 14 15
10 15 6 6 6 6 3 0 0 0 0 0 1 2 10 15
14 10 6 6 6 0 4 0 0 0 0 0 1 2 14 15 
10 14 0 0 0 0 4 0 0 0 0 1 2 2 15 10
10 13 0 6 6 0 4 0 0 0 0 1 2 2 10 10
14 10 6 6 0 0 5 0 0 1 2 2 2 2 15 10 
14 10 10 14 10 14 10 15 10 10 10 10 10 10 10 10
10 10 10 10 10 10 10 10 15 10 10 10 15 10 10 10