32 32
14 10 10 10 13 10 10 10 10 10 10 10 10 10 10 10 14 15 10 14 10 13 10 15 10 14 14 14 13 10 10 14
10 10 10 14 10 10 10 15 10 10 10 10 10 10 10 10 17 13 13 15 14 15 13 14 13 18 10 15 14 15 10 15
14 10  0  0  0  0  0  0  0  0  0  0  0  0  0 16  0  1 15 10  7  8  9  8  9  7  9  7  8  7 13 13
13 10  0  0  3  0  0  0  0  0  0  0  0  0  0 16  0  1 10 10  8  8  7  9  7  8  9  9  8  8 10 15
10 11  0  0  4  0  0  0  0  0  0  0  0  0 16  0  0  1 10 10  7  7  9  8  7  8  9  7  8  7 14 10
10 12  0  0  4  0  0  0  0  0  0  0  0  0 16  0  0  1 14 10  9  9  8  7  7  9  7  7  9  9 13 10
14 10  0  0  5  0  0  0  0  0  0  0  0  0 16  0  0  1 10 13  8  9  7  8  7  7  8  7  8  7 15 13
10 15  0  0  0  0  0  0  0  0  0  0  0  0 16  0  0  1 13 10  8  7  8  9  7  8  7  8  7  8 13 14
10 10  0  0  0  0  0  0  0  0  0  0  0  0 16  0  0  1 14 15  7  9  8  7  7  9  8  9  9  9 10 13
10 15  0  0  0  0  3  0  0  0  0  0  1  0  0 16  0  1 10 15  9  7  8  7  9  8  9  7  8  8 15 14
14 10  0  0  0  0  4  0  0  0  0  0  1  2  0 16  0  1 14 15  7  8  7  9  9  8  7  7  9  7 13 15
10 14  0  0  0  0  4  0  0  0  0  1  2  2  0 16  0  1 15 10 13 14 15 14 14 10 19 13 10 13 10 10
10 13  0  0  0  0  4  0  0  0  0  1  2  2  0 16  0  1 10 10 14 15 13 13 10 10 10 13 14 15 15 13
14 10  0  0  0  0  4  0  0  1  2  2  2  2  0 16  0  1 15 10 15 13 10 14 10 13 15 13 10 14 13 10
13 15  0  0  0  0  4  0  0  0  0  0  0  0  0 16  0  1 13 15 13 10 13 15 10 18 14 10 13 10 15 14
14 10  0  0  0  0  4  0  0  1  2  2 16  1  2 16  0  1 10 13  2  2  2 16  0  0  0  1  2  0 14 13
10 13  0  0  0  0  4  0  1  2  2  2  2  2  2 16  0  1 14 10  2 16  0  0  0  1  2  2  2  0 10 14
14 10  0  0  0  0  5  0  0  0  0  1  2  2 16  0  1  2 15 13  2  2 16  0  0  0  1  2  2  0 15 15
15 13 10 14 19 14 10 21 14 10 10 10 10 10 10 10 15 10 10 13 15 10 15  0  0  0  0  1  2  0 13 10
10 10 10 10 10 10 10  0 15 10 10 10 15 10 10 10 13 14 14 10 14 13 14  0  0  0  0  0  1  0 13 15
13 14  0  0  0  0  0  0  0  0  0  0  0  0  0  0  0  0  0  0  0  0  0  0  0  0  0  0  0  0 14 10
13 10  0  0  0  0  0  0  0  0  0  0  0  0  0  0  0  0  0  0  0  0  0  0  0  0  0  0  0  0 15 14
10 15  0  0  0  0  0  0  0  0  0  0  0  0  0  0  0  0  0  0  0  0  0  0  0  0  0  0  0  0 14 10
10 13  0  0  0  0  1  2  2  2  2  2  2 16  0  0  0  0  0  0  0  0  1 16  0  0  0  0  0  0 13 14
14 13  0  0  0  0  0  0  1  2  2  0  2  2  2 16  0  0  0  0  0  0  0  0  0  0  0  0  0  0 14 13
15 10  0  0  0  0  0  0  0  0  1  2  2  2 16  0  0  0  0  0  0  0  0  0  0  0  0  0  0  0 13 10
13 10  0  0  0  0  0  0  0  0  0  0  0  0  0  0  0  0  1  2  2 16  0  0  0  0  0  0  0  0 15 13
10 15  0  0  0  1  2  2 16  0  0  0  0  0  0  0  0  0  0  0  0  0  0  0  0  0  0  0  0  0 13 15
14 15  0  0  0  0  0  0  0  0  0  0  0  0  0  0  0  0  0  0  0  0  0  0  0  0  0  0  0  0 15 14
15 10  0  0  0  0  0  0  0  0  0  0  0  0  0  0  0  0  0  0  0  0  0  0  0  0  0  0  0  0 13 10
10 13 14 15 13 14 15 10 13 10 10 13 14 10 15 14 13 10 14 13 15 10 13 10 14 15 13 14 10 13 14 13
15 13 10 14 10 13 14 15 10 14 13 14 10 14 10 13 10 15 14 10 14 13 10 13 10 14 15 10 13 14 10 14