32 32
14 10 10 10 13 10 10 10 10 10 10 10 10 10 10 10 14 15 10 14 10 13 10 15 10 14 14 14 13 10 10 14
10 10 10 14 10 10 10 15 10 10 10 10 10 10 10 10 13 13 13 15 14 15 13 14 13 14 10 15 14 15 10 15
14 11 0 0 0 0 0 0 0 0 24 10 6 6 10 26 0 25 0 0 7 8 9 8 9 7 9 7 8 7 13 13
13 12 0 0 0 0 0 0 0 0 0 10 6 6 10 16 0 1 10 10 8 8 7 9 7 8 9 9 8 8 10 15
10 10 10 10 10 10 10 10 10 0 0 10 6 6 10 16 0 1 10 10 10 10 10 10 7 8 10 10 10 10 14 10
10 10 0 0 0 0 0 0 10 0 0 10 0 0 10 16 0 1 14 10 9 9 8 7 7 9 7 7 9 9 13 10
14 10 0 25 21 21 26 0 10 0 0 10 0 0 10 16 0 1 10 13 8 9 7 8 7 7 8 7 8 7 15 13
10 15 0 1 2 2 16 0 10 0 0 10 0 0 10 16 0 1 13 10 8 7 10 10 7 8 10 10 7 8 13 14
10 10 0 1 2 2 16 0 10 0 0 0 0 0 10 16 0 1 14 15 7 9 10 10 7 9 10 10 9 9 10 13
10 15 0 24 22 22 23 0 10 0 0 0 0 0 10 16 0 1 10 15 9 7 8 7 9 8 9 7 8 8 15 14
14 10 0 0 0 0 0 0 10 10 10 10 0 0 10 16 0 1 14 15 7 8 7 9 9 8 7 7 9 7 13 15
10 14 0 0 10 10 0 0 0 0 3 0 0 25 10 23 0 1 15 10 13 14 15 14 14 0 19 13 10 13 10 10
10 13 0 0 10 10 6 0 0 0 5 0 25 27 10 0 0 1 10 10 14 15 13 13 10 0 10 13 14 15 15 13
14 10 6 0 10 10 10 10 10 10 10 10 10 10 10 0 0 1 15 10 15 13 10 14 10 0 15 13 10 14 13 10
13 15 0 0 10 10 10 10 10 10 10 10 10 10 10 26 0 1 13 15 13 10 13 15 10 0 14 10 13 10 15 14
14 10 0 0 10 10 25 21 21 21 26 0 0 0 24 23 0 1 10 13 2 2 2 16 0 0 30 2 2 2 14 13
10 13 0 0 0 0 1 2 2 2 16 0 0 0 0 0 0 1 14 10 2 16 0 0 0 0 27 2 2 2 10 14
14 10 0 0 6 0 24 22 22 22 23 25 21 21 26 0 0 24 15 13 2 2 16 0 0 0 30 2 2 2 15 15
15 13 10 14 10 14 10 10 14 10 10 10 10 10 10 10 13 10 10 13 15 10 15 0 0 0 0 30 2 29 13 10
10 10 10 10 10 10 10 10 15 10 10 10 15 10 10 10 15 14 14 10 14 13 14 0 0 0 0 24 22 23 13 15
13 14 0 0 0 0 0 0 0 0 0 0 0 0 10 0 0 0 0 0 6 6 10 0 0 0 0 0 0 0 14 10
13 10 0 0 10 0 0 0 0 0 0 10 10 0 10 0 0 0 0 0 0 6 10 0 0 0 0 0 0 0 15 14
10 15 0 10 10 6 0 0 0 0 0 10 10 0 10 0 0 10 0 0 0 0 10 10 10 10 10 10 10 0 14 10
10 13 0 10 10 0 0 6 6 6 0 6 6 0 10 0 0 10 0 0 10 0 10 10 10 10 10 10 10 0 13 14
14 13 0 0 0 0 0 10 10 6 0 0 0 0 0 0 0 10 0 0 0 0 10 0 0 0 0 0 10 0 14 13
15 10 0 0 0 0 0 10 10 6 0 0 0 0 0 0 0 10 0 0 0 0 10 0 10 0 10 0 10 0 13 10
13 10 0 10 10 0 0 6 6 6 0 6 6 0 10 0 0 10 0 0 10 10 10 0 0 0 0 0 10 0 15 13
10 15 0 10 10 6 0 0 0 0 0 10 10 0 10 0 0 10 0 0 0 13 0 0 0 0 10 10 10 0 13 15
14 15 0 0 10 0 0 0 0 0 0 10 10 0 10 0 0 10 0 0 0 32 0 0 0 0 0 0 0 0 15 14
15 10 0 0 0 0 0 0 0 0 0 0 0 0 10 0 0 10 0 0 0 15 0 0 0 0 0 0 0 0 13 10
10 13 14 15 13 14 15 10 13 10 10 13 14 10 15 14 13 10 14 13 15 10 13 10 14 15 13 14 10 13 14 13
15 13 10 14 10 13 14 15 10 14 13 14 10 14 10 13 10 15 14 10 14 13 10 13 10 14 15 10 13 14 10 14